Solution to THE LURKING HORROR.

(c) 1992 Erik Futtrup, Denmark (email: futtrup@daimi.aau.dk)
     and Twan Lintermans, Holland


sit down: examine pc: turn pc on: press help key: login xxx {xxx
= the number on the student ID card}: password uhlersoth: click
menu with mouse: click paper: read text: click more box: again
(3x): {sound}: d: d: take stone [5pts]: wait (2x): {sound gone}:
examine hacker: ask hacker about keys: {notice the master key!}:
inventory: ask hacker about lovecraft {gag}: s: w: open fridge:
take coke and carton: x carton: open carton: x microwave: x
controls: open microwave: put carton in it: close microwave:
press 5: press 0: press 0: press hi: press start: wait (4x): open
microwave: take carton: e: n: hacker, give me master key: hacker,
help me: give carton to hacker: hacker, give me master key:
[5pts]: drop assignment: s: press d: wait (2x): s: open panel:
take flashlight: press 1: wait (4x): n: d: e: take gloves and
crowbar: w (3x): u: s: take container: e: x container: read
container: open container: {go east when man lets you!}: e:
again: wear gloves: smash cabinet: x it: take axe: e: hit cord
with axe: x man: hit man with axe {sound}: pour wax on floor:
[5pts]: take axe: n: d: se: take boots then wear them: u: u:
unlock door with key: open door: w: x dome: u: dig earth with
hands: take hand [5pts]: d: throw stone at shape [5pts] {sound}:
e: d: s: take stone: n: d: nw: u: s: drop container: w (4x): n:
d: e: enter forklift: turn it on: e (3x): turn flashlight on:
move junk with forklift: again (3x): d: e: [5pts]: open manhole
with crowbar: d: [5pts]: n: d: take knife: open plate {sound}:
close plate: u: s: s: open trap door {hits sth; where does it
lead to?}: n: u: w: w: turn flashlight off: w: drop
stone,axe,crowbar: w: w: u: s: e: e: u: climb rope: [5pts] {don't
forget to wear gloves!}: open door: n: u: take plug: drop it:
take paper: [5pts]: read it: d: s: drop all: take ladder: put
ladder on catwalk: take all: d: d: e: e: s: knock on door: wait:
show paper to prof {he won't let you in the lab, if you don't}:
s: x bench: drink coke {energy!}: cut line with knife: {2 turns
after getting into the lab!}: leave pentagram: {sound}: move
bench: {remember the trap door?}: open trapdoor: d: [5pts]: turn
flashlight on: open trapdoor: u: read vat: put human hand in vat:
wait (2x): take hand [5pts]: n: open door: n: turn flashlight
off: n: w: w (3x): n: d: {urchin is here; otherwise find him}:
show hand to urchin: look: {everything back what we dropped
before Ñ so be careful not to drop it too soon!}: take all:
[5pts]: drop axe and cutter: d: nw: unlock padlock with key: take
it: open hatch {sound}: d: {sound}: [5pts]: e: open valve with
crowbar: wait (3x): open valve with crowbar [5pts]: e: turn
flashlight on: e: move brick with crowbar: move new brick with
crowbar: w: w: close valve: w: u: turn light off: se: u: take
cutter and axe: e: e: open doors: put crowbar between them: s:
[5pts]: take chain: put it around rod: put padlock on chain: u:
drop chain: take crowbar: u: {press d, wait until elevator
arrives, then: ......}: d: open doors: put crowbar between doors:
take chain: fasten it to hook: take crowbar: u: press u: s: press
2: press open: n: d: wait (2x): {sound}: [5pts]: open doors: put
crowbar between doors: drop knife and hand: e: u: turn light on:
take flask: d: w: s: n: w (5x): d (2x): {sound}: cut wire with
cutter: [5pts]: d: s: w: s: s: d: {through maze!}: pour flask on
curtain: [5pts]: unlock door with key: open door: s: {sound}:
open box: take coaxial cable out of connector: search pool: take
line: cut line with axe: again (2x): take line: put line in
connector: [5pts]:  {sound}: wait: throw stone at thing [5pts]:
take stone {sounds}

100 points out of 100!
